1111111111111111111111111111111111111111
1000X0000000000C00000C000000X000000000C1
101001010010000X101001000000010100000001
1010010010101010001001000000010100000001
1P0000000C00C0000000000000000000C0000001
100000000000000C000000000000000000000001
10000000X00000000000X0000000000000000001
1000000000000000000000000000000000000001
1000000000001110000000000000000000000001
10C0001001001C1000X000000000000000000001
10000000000010100000000000000X0000000001
10000000000010111X1000000000000000000001
1000000000101000001000000000000000000001
1000000000001110111000000000000000000001
1000000000000000000000000000000000000001
100000000XX00000000000000000X00000000001
1000X00000000001111110000000000000000001
1X000000000000010X001000000000000000X001
1000000000000001000010000000001111001111
1E0000X0000000C10E001C00000X0000000000C1
1111111111111111111111111111111111111111